PLANE 7 7
#######
#*****#
#*#*#*#
#*****#
#*#*#*#
#h****#
#######
